%%%%%%%%
%P.....%
%.%..%.%
%.%..%.%
%.%..%.%
%.....G%
%%%%%%%%
