%%%%%%%
%P    %
% .%. %
%  %  %
% .%. %
%    G%
%%%%%%%
