%%%%%%%%%%%%%%
%....%GG%....%
%.%%.%  %.%%.%
%.o........o.%
%.%%.%%%%.%%.%
%.....P......%
%%%%%%%%%%%%%%
