%%%%%%%
%.P...%
%.%%%.%
%.%...%
%.%%%.%
%..G..%
%%%%%%%
